match_number,date,hour,value,total_bet_red,total_bet_green,total_bet_black,total_bet
1,2019-04-14,01:27:53,2,4665,4351,802,9818
2,2019-04-14,01:28:15,9,7662,5758,686,14106
3,2019-04-14,01:28:41,6,2151,6744,204,9099
4,2019-04-14,01:29:05,4,2502,3056,4049,9607
5,2019-04-14,01:29:30,1,552,7905,3701,12158
6,2019-04-14,01:29:56,14,411,2205,4493,7109
7,2019-04-14,01:30:20,12,849,2265,2740,5854
8,2019-04-14,01:30:46,11,3040,7164,52,10256
9,2019-04-14,01:31:10,3,549,4667,4658,9874
10,2019-04-14,01:31:36,10,850,5248,2711,8809
11,2019-04-14,01:32:01,1,49,4163,2002,6214
12,2019-04-14,01:32:26,10,7102,3654,299,11055
13,2019-04-14,01:32:51,6,49,5498,3502,9049
14,2019-04-14,01:33:16,6,3595,2112,49,5756
15,2019-04-14,01:33:40,11,1004,4461,49,5514
16,2019-04-14,01:34:06,8,1,4605,50,4656
17,2019-04-14,01:34:31,13,251,3326,2052,5629
18,2019-04-14,01:34:56,13,1999,1694,1258,4951
19,2019-04-14,01:35:21,13,669,1731,1164,3564
20,2019-04-14,01:35:46,14,2119,2457,80,4656
21,2019-04-14,01:36:10,1,3833,479,500,4812
22,2019-04-14,01:36:36,8,1964,1727,1594,5285
23,2019-04-14,01:37:01,9,1251,1512,826,3589
24,2019-04-14,01:37:26,8,2599,3249,474,6322
25,2019-04-14,01:37:51,2,1,347,682,1030
26,2019-04-14,01:38:16,11,1366,3842,49,5257
27,2019-04-14,01:38:41,5,1,2562,426,2989
28,2019-04-14,01:39:06,3,47453,1000,49,48502
29,2019-04-14,01:39:31,5,2234,3615,1,5850
30,2019-04-14,01:39:56,8,620,3006,101,3727
31,2019-04-14,01:40:21,14,1934,1639,50,3623
32,2019-04-14,01:40:46,11,1,147,302,450
33,2019-04-14,01:41:11,6,2770,1844,122,4736
34,2019-04-14,01:41:36,12,1074,1841,3001,5916
35,2019-04-14,01:42:01,14,25,5785,2,5812
36,2019-04-14,01:42:26,2,6501,3193,254,9948
37,2019-04-14,01:42:51,6,2,1736,1,1739
38,2019-04-14,01:43:16,6,1018,2063,1,3082
39,2019-04-14,01:43:41,14,5008,3903,2,8913
40,2019-04-14,01:44:06,14,6401,3650,2,10053
41,2019-04-14,01:44:31,7,6,3096,752,3854
42,2019-04-14,01:44:56,13,2404,3992,4593,10989
43,2019-04-14,01:45:21,8,951,3791,2580,7322
44,2019-04-14,01:45:46,1,4417,3246,947,8610
45,2019-04-14,01:46:11,12,2144,3511,2060,7715
46,2019-04-14,01:46:36,10,1252,6238,3290,10780
47,2019-04-14,01:47:01,2,550,3475,654,4679
48,2019-04-14,01:47:26,5,1292,4711,3250,9253
49,2019-04-14,01:47:51,7,4222,4194,527,8943
50,2019-04-14,01:48:16,14,1828,1503,1100,4431
51,2019-04-14,01:48:41,4,1918,2152,3250,7320
52,2019-04-14,01:49:06,14,175,4614,2002,6791
53,2019-04-14,01:49:31,11,60,12663,39102,51825
54,2019-04-14,01:49:56,2,300,3712,3204,7216
55,2019-04-14,01:50:21,14,175,3197,2,3374
56,2019-04-14,01:50:46,9,1752,7087,2,8841
57,2019-04-14,01:51:11,8,650,5904,4,6558
58,2019-04-14,01:51:36,0,202,3937,6793,10932
59,2019-04-14,01:52:01,11,222,11258,2902,14382
60,2019-04-14,01:52:26,1,4002,4941,400,9343
61,2019-04-14,01:52:51,10,25581,4923,24261,54765
62,2019-04-14,01:53:16,4,50,3928,1802,5780
63,2019-04-14,01:53:41,1,4420,5108,5452,14980
64,2019-04-14,01:54:06,7,292,3056,12,3360
65,2019-04-14,01:54:31,12,3488,2908,50,6446
66,2019-04-14,01:54:56,13,3276,2260,50,5586
67,2019-04-14,01:55:21,7,4002,2571,52,6625
68,2019-04-14,01:55:46,14,2709,3904,3412,10025
69,2019-04-14,01:56:11,0,2250,3608,77,5935
70,2019-04-14,01:56:36,2,856,4858,3050,8764
71,2019-04-14,01:57:01,13,5344,6254,50,11648
72,2019-04-14,01:57:26,14,6746,3601,1002,11349
73,2019-04-14,01:57:51,14,4524,5261,4,9789
74,2019-04-14,01:58:16,14,18157,7782,1008,26947
75,2019-04-14,01:58:41,1,6035,7226,64,13325
76,2019-04-14,01:59:06,5,4050,2726,386,7162
77,2019-04-14,01:59:31,0,3052,4190,402,7644
78,2019-04-14,01:59:56,11,502,9242,5550,15294
79,2019-04-14,02:00:21,0,3112,7748,2650,13510
80,2019-04-14,02:00:46,1,5050,11681,11502,28233
81,2019-04-14,02:01:11,14,4666,9136,24002,37804
82,2019-04-14,02:01:36,10,2,5443,837,6282
83,2019-04-14,02:02:01,14,49,343,10,402
84,2019-04-14,02:02:26,1,1,5274,68,5343
85,2019-04-14,02:02:51,5,0,1690,99,1789
86,2019-04-14,02:03:16,9,528,1404,102,2034
87,2019-04-14,02:03:41,12,1549,2360,10,3919
88,2019-04-14,02:04:06,14,14001,234,58,14293
89,2019-04-14,02:04:31,13,11,957,68,1036
90,2019-04-14,02:04:56,11,11,44,68,123
91,2019-04-14,02:05:21,9,21,544,58,623
92,2019-04-14,02:05:46,5,51,368,48,467
93,2019-04-14,02:06:11,14,73,7524,1043,8640
94,2019-04-14,02:06:36,5,61,428,48,537
95,2019-04-14,02:07:01,3,5,609,49,663
96,2019-04-14,02:07:26,1,2005,635,49,2689
97,2019-04-14,02:07:51,12,35,266,4149,4450
98,2019-04-14,02:08:16,1,3159,1592,0,4751
99,2019-04-14,02:08:41,10,53,266,1,320
100,2019-04-14,02:09:06,14,31,74,48,153
101,2019-04-14,02:09:31,7,51,776,48,875
102,2019-04-14,02:09:56,12,25,2442,49,2516
103,2019-04-14,02:10:21,5,159,554,0,713
104,2019-04-14,02:10:46,10,691,4973,49,5713
105,2019-04-14,02:11:11,5,438,3129,3000,6567
106,2019-04-14,02:11:36,6,3657,1884,1505,7046
107,2019-04-14,02:12:01,13,3349,2703,3340,9392
108,2019-04-14,02:12:26,5,3260,2389,0,5649
109,2019-04-14,02:12:51,10,55,1440,3001,4496
110,2019-04-14,02:13:16,13,60,3502,1400,4962
111,2019-04-14,02:13:41,0,1022,3865,0,4887
112,2019-04-14,02:14:06,3,790,5238,1,6029
113,2019-04-14,02:14:31,8,1807,4156,937,6900
114,2019-04-14,02:14:56,9,1260,4065,0,5325
115,2019-04-14,02:15:21,7,422,3520,1548,5490
116,2019-04-14,02:15:46,6,107,2437,2549,5093
117,2019-04-14,02:16:11,3,9,857,1382,2248
118,2019-04-14,02:16:36,6,281,1439,516,2236
119,2019-04-14,02:17:01,4,2021,2032,1,4054
120,2019-04-14,02:17:26,3,3085,2743,1001,6829
121,2019-04-14,02:17:51,6,2569,1718,1537,5824
122,2019-04-14,02:18:16,11,3181,3030,8101,14312
123,2019-04-14,02:18:41,10,12,3807,7048,10867
124,2019-04-14,02:19:06,10,23522,4776,527,28825
125,2019-04-14,02:19:31,9,5042,3985,68,9095
126,2019-04-14,02:19:56,0,132,2338,68,2538
127,2019-04-14,02:20:21,3,410,3938,1,4349
128,2019-04-14,02:20:46,2,1255,2152,3501,6908
129,2019-04-14,02:21:11,2,609,3726,201,4536
130,2019-04-14,02:21:36,9,2613,2802,449,5864
131,2019-04-14,02:22:01,12,2282,1302,1049,4633
132,2019-04-14,02:22:26,7,522,4305,2249,7076
133,2019-04-14,02:22:51,7,2108,1502,1549,5159
134,2019-04-14,02:23:16,7,6917,3007,101,10025
135,2019-04-14,02:23:41,8,62,2302,201,2565
136,2019-04-14,02:24:06,14,938,2918,638,4494
137,2019-04-14,02:24:31,1,10602,3879,1705,16186
138,2019-04-14,02:24:56,13,831,3596,703,5130
139,2019-04-14,02:25:21,3,12,1505,1653,3170
140,2019-04-14,02:25:46,1,7,2124,6101,8232
141,2019-04-14,02:26:11,12,9237,1502,10381,21120
142,2019-04-14,02:26:36,13,12,2026,200,2238
143,2019-04-14,02:27:01,5,10750,3002,100,13852
144,2019-04-14,02:27:26,11,10035,502,1,10538
145,2019-04-14,02:27:51,9,12,24522,248,24782
146,2019-04-14,02:28:16,9,722,10472,1148,12342
147,2019-04-14,02:28:41,0,2605,1981,2848,7434
148,2019-04-14,02:29:06,1,3330,4082,2304,9716
149,2019-04-14,02:29:31,0,2512,3899,249,6660
150,2019-04-14,02:29:56,11,5420,1880,1971,9271
151,2019-04-14,02:30:21,0,4841,1824,864,7529
152,2019-04-14,02:30:47,0,2976,2473,355,5804
153,2019-04-14,02:31:11,2,2930,2698,613,6241
154,2019-04-14,02:31:36,7,1067,2853,4253,8173
155,2019-04-14,02:32:02,2,1621,2372,1169,5162
156,2019-04-14,02:32:26,4,22285,17379,6501,46165
157,2019-04-14,02:32:51,0,10885,10987,1,21873
158,2019-04-14,02:33:16,9,26978,10653,49,37680
159,2019-04-14,02:33:41,1,42522,12019,1068,55609
160,2019-04-14,02:34:06,3,5055,15684,6204,26943
161,2019-04-14,02:34:31,12,10235,8407,1101,19743
162,2019-04-14,02:34:56,13,1348,3406,100,4854
163,2019-04-14,02:35:21,5,14070,1020,534,15624
164,2019-04-14,02:35:46,8,22355,8814,1,31170
165,2019-04-14,02:36:11,0,12,552,796,1360
166,2019-04-14,02:36:36,7,50022,17576,49,67647
167,2019-04-14,02:37:02,10,20485,3347,751,24583
168,2019-04-14,02:37:26,11,362,351,0,713
169,2019-04-14,02:37:51,2,51170,10898,1800,63868
170,2019-04-14,02:38:17,4,103,5191,1,5295
171,2019-04-14,02:38:42,8,1683,14441,3001,19125
172,2019-04-14,02:39:07,0,512,770,6300,7582
173,2019-04-14,02:39:32,6,32622,20772,349,53743
174,2019-04-14,02:39:56,2,20107,10792,349,31248
175,2019-04-14,02:40:22,3,13796,11948,1784,27528
176,2019-04-14,02:40:47,5,11190,15660,7406,34256
177,2019-04-14,02:41:12,7,10456,2857,4215,17528
178,2019-04-14,02:41:37,5,9438,7298,3687,20423
179,2019-04-14,02:42:02,4,19179,11701,6499,37379
180,2019-04-14,02:42:26,6,9991,12044,7806,29841
181,2019-04-14,02:42:52,7,36169,12854,1961,50984
182,2019-04-14,02:43:17,0,20841,12572,151,33564
183,2019-04-14,02:43:42,4,1482,6933,829,9244
184,2019-04-14,02:44:07,9,41915,22020,11061,74996
185,2019-04-14,02:44:32,9,42192,2610,22336,67138
186,2019-04-14,02:44:57,13,162,2957,12902,16021
187,2019-04-14,02:45:22,0,106712,2606,2406,111724
188,2019-04-14,02:45:47,1,171045,27219,2616,200880
189,2019-04-14,02:46:12,1,24489,22319,351,47159
190,2019-04-14,02:46:37,1,38807,22788,401,61996
191,2019-04-14,02:47:02,1,3868,22758,332,26958
192,2019-04-14,02:47:27,1,36314,50643,871,87828
193,2019-04-14,02:47:52,2,3490,8511,645,12646
194,2019-04-14,02:48:17,5,29713,2799,3336,35848
195,2019-04-14,02:48:42,14,20780,8148,20349,49277
196,2019-04-14,02:49:07,0,102,3635,10480,14217
197,2019-04-14,02:49:32,5,5801,12549,2075,20425
198,2019-04-14,02:49:57,7,41086,16637,21569,79292
199,2019-04-14,02:50:22,2,16208,13316,3541,33065
200,2019-04-14,02:50:47,11,11344,2502,7704,21550
201,2019-04-14,02:51:12,14,15150,22694,12310,50154
202,2019-04-14,02:51:37,4,1291,12144,15804,29239
203,2019-04-14,02:52:02,1,100794,4326,16592,121712
204,2019-04-14,02:52:27,9,6288,4122,6630,17040
205,2019-04-14,02:52:52,8,8250,4926,10872,24048
206,2019-04-14,02:53:17,1,51083,6340,4870,62293
207,2019-04-14,02:53:42,0,17455,4799,1,22255
208,2019-04-14,02:54:07,3,11992,13978,2,25972
209,2019-04-14,02:54:32,1,14991,12512,10275,37778
210,2019-04-14,02:54:57,14,12874,3097,53,16024
211,2019-04-14,02:55:22,1,31523,4743,8010,44276
212,2019-04-14,02:55:47,4,642,3746,5820,10208
213,2019-04-14,02:56:12,2,7298,5712,351,13361
214,2019-04-14,02:56:37,6,12756,13345,1076,27177
215,2019-04-14,02:57:02,12,3046,7195,5,10246
216,2019-04-14,02:57:27,5,349,5431,6199,11979
217,2019-04-14,02:57:52,11,14443,10387,5604,30434
218,2019-04-14,02:58:17,4,11088,13871,4050,29009
219,2019-04-14,02:58:42,10,3939,1536,10248,15723
220,2019-04-14,02:59:07,3,12019,1277,1319,14615
221,2019-04-14,02:59:32,10,13637,5612,15506,34755
222,2019-04-14,02:59:57,2,38724,2959,1548,43231
223,2019-04-14,03:00:22,14,1332,968,13980,16280
224,2019-04-14,03:00:47,10,28401,7757,528,36686
225,2019-04-14,03:01:12,14,46240,1011,7237,54488
226,2019-04-14,03:01:37,7,12619,2277,221,15117
227,2019-04-14,03:02:02,3,59758,1787,1494,63039
228,2019-04-14,03:02:27,11,25986,2818,8104,36908
229,2019-04-14,03:02:52,11,16867,1313,25953,44133
230,2019-04-14,03:03:17,1,12250,1130,1823,15203
231,2019-04-14,03:03:42,3,10795,1452,1482,13729
232,2019-04-14,03:04:07,8,6552,5815,20248,32615
233,2019-04-14,03:04:32,4,377,1257,16742,18376
234,2019-04-14,03:04:57,1,613,955,148,1716
235,2019-04-14,03:05:22,0,336,1306,593,2235
236,2019-04-14,03:05:47,9,52,5022,77,5151
237,2019-04-14,03:06:12,4,365,1507,172,2044
238,2019-04-14,03:06:37,13,298,837,112,1247
239,2019-04-14,03:07:02,6,203,1005,296,1504
240,2019-04-14,03:07:27,4,2,996,882,1880
241,2019-04-14,03:07:52,3,826,1056,370,2252
242,2019-04-14,03:08:17,11,1196,499,3,1698
243,2019-04-14,03:08:42,1,2,1039,11494,12535
244,2019-04-14,03:09:07,9,4056,750,15001,19807
245,2019-04-14,03:09:32,12,118,879,10000,10997
246,2019-04-14,03:09:57,12,203,1521,10072,11796
247,2019-04-14,03:10:22,4,438,101062,15200,116700
248,2019-04-14,03:10:47,4,17184,747,1,17932
249,2019-04-14,03:11:12,11,300,151147,15002,166449
250,2019-04-14,03:11:37,8,2831,151887,17622,172340
251,2019-04-14,03:12:02,8,2143,151599,1266,155008
252,2019-04-14,03:12:27,14,5281,201998,6445,213724
253,2019-04-14,03:12:52,12,3057,250902,3488,257447
254,2019-04-14,03:13:17,3,1179,301991,3102,306272
255,2019-04-14,03:13:42,13,2038,502271,4178,508487
256,2019-04-14,03:14:07,7,5639,552308,5787,563734
257,2019-04-14,03:14:32,3,502,602560,1676,604738
258,2019-04-14,03:14:57,3,1796,751727,851,754374
259,2019-04-14,03:15:22,0,1109,752409,528,754046
260,2019-04-14,03:15:47,14,21191,204515,77,225783
261,2019-04-14,03:16:12,6,1,251648,3072,254721
262,2019-04-14,03:16:37,6,72,1364,5224,6660
263,2019-04-14,03:17:02,8,72,1593,213,1878
264,2019-04-14,03:17:27,11,648,1364,72,2084
265,2019-04-14,03:17:52,13,1142,1035,0,2177
266,2019-04-14,03:18:17,2,2547,930,184,3661
267,2019-04-14,03:18:42,13,0,1010,72,1082
268,2019-04-14,03:19:07,11,112,119,1394,1625
269,2019-04-14,03:19:32,14,44,2829,2042,4915
270,2019-04-14,03:19:57,1,12402,3116,572,16090
271,2019-04-14,03:20:22,4,4500,2251,520,7271
272,2019-04-14,03:20:47,8,340,2320,981,3641
273,2019-04-14,03:21:13,2,19724,3636,10587,33947
274,2019-04-14,03:21:37,1,15320,1484,495,17299
275,2019-04-14,03:22:02,2,150,2024,5621,7795
276,2019-04-14,03:22:27,13,200,928,2977,4105
277,2019-04-14,03:22:52,7,5402,1276,100,6778
278,2019-04-14,03:23:17,14,15712,4056,0,19768
279,2019-04-14,03:23:42,11,448,3508,2221,6177
280,2019-04-14,03:24:07,8,501,4290,300,5091
281,2019-04-14,03:24:32,9,519,1155,450,2124
282,2019-04-14,03:24:57,12,784,902,0,1686
283,2019-04-14,03:25:22,6,3533,1584,2501,7618
284,2019-04-14,03:25:47,3,0,1127,0,1127
285,2019-04-14,03:26:12,6,2420,246,1,2667
286,2019-04-14,03:26:37,14,200,339,2902,3441
287,2019-04-14,03:27:02,1,3250,922,1176,5348
288,2019-04-14,03:27:27,7,72,1367,1564,3003
289,2019-04-14,03:27:52,10,4872,1924,1151,7947
290,2019-04-14,03:28:17,5,45072,2643,2324,50039
291,2019-04-14,03:28:42,7,72,2246,651,2969
292,2019-04-14,03:29:07,10,1572,827,2321,4720
293,2019-04-14,03:29:32,9,12849,1743,3170,17762
294,2019-04-14,03:29:57,11,501,1327,1622,3450
295,2019-04-14,03:30:22,4,16512,1146,3396,21054
296,2019-04-14,03:30:47,10,1560,1863,2500,5923
297,2019-04-14,03:31:13,11,36000,690,177,36867
298,2019-04-14,03:31:37,14,626,887,2630,4143
299,2019-04-14,03:32:02,5,139564,3552,94,143210
300,2019-04-14,03:32:28,10,177,530,5263,5970
301,2019-04-14,03:32:52,9,7563,12626,24836,45025
302,2019-04-14,03:33:18,4,292,8751,8124,17167
303,2019-04-14,03:33:42,3,72,5128,1030,6230
304,2019-04-14,03:34:07,11,2400,8986,98,11484
305,2019-04-14,03:34:32,14,2685,12540,2786,18011
306,2019-04-14,03:34:57,13,13424,5491,4980,23895
307,2019-04-14,03:35:22,5,18237,5990,7170,31397
308,2019-04-14,03:35:47,9,472,4497,4750,9719
309,2019-04-14,03:36:12,10,1010,3970,6922,11902
310,2019-04-14,03:36:37,1,10,3076,1132,4218
311,2019-04-14,03:37:02,8,21856,14904,3020,39780
312,2019-04-14,03:37:27,7,10,2621,82,2713
313,2019-04-14,03:37:52,1,42956,3681,1110,47747
314,2019-04-14,03:38:17,9,100,2186,15000,17286
315,2019-04-14,03:38:43,11,82,13066,69025,82173
316,2019-04-14,03:39:08,6,15137,23126,4700,42963
317,2019-04-14,03:39:32,1,119675,10235,25077,154987
318,2019-04-14,03:39:58,2,4520,6674,0,11194
319,2019-04-14,03:40:22,6,72,4698,140,4910
320,2019-04-14,03:40:47,6,530,3039,2432,6001
321,2019-04-14,03:41:12,2,72,2806,260,3138
322,2019-04-14,03:41:37,3,602,3315,0,3917
323,2019-04-14,03:42:02,1,33072,11636,120,44828
324,2019-04-14,03:42:28,6,1825,2676,200,4701
325,2019-04-14,03:42:53,9,1185,4561,440,6186
326,2019-04-14,03:43:18,9,3119,4936,0,8055
327,2019-04-14,03:43:43,13,125072,28960,30,154062
328,2019-04-14,03:44:07,13,24453,1976,0,26429
329,2019-04-14,03:44:33,12,12869,2661,72,15602
330,2019-04-14,03:44:57,10,36388,5626,72,42086
331,2019-04-14,03:45:22,2,57092,36,572,57700
332,2019-04-14,03:45:47,4,90,1219,0,1309
333,2019-04-14,03:46:12,8,31820,3301,72,35193
334,2019-04-14,03:46:37,9,40000,2637,6072,48709
335,2019-04-14,03:47:03,12,31,10242,72,10345
336,2019-04-14,03:47:27,10,10,9044,72,9126
337,2019-04-14,03:47:52,4,21,1044,72,1137
338,2019-04-14,03:48:18,6,1495,16971,884,19350
339,2019-04-14,03:48:43,14,9571,995,524,11090
340,2019-04-14,03:49:08,0,90246,642,72,90960
341,2019-04-14,03:49:33,0,190038,33148,3816,227002
342,2019-04-14,03:49:58,10,16642,12948,0,29590
343,2019-04-14,03:50:23,10,6107,3088,72,9267
344,2019-04-14,03:50:47,3,1718,8136,0,9854
345,2019-04-14,03:51:13,9,71884,11630,1500,85014
346,2019-04-14,03:51:37,0,174700,1680,267,176647
347,2019-04-14,03:52:03,0,1750,1882,72,3704
348,2019-04-14,03:52:28,1,17785,3149,8000,28934
349,2019-04-14,03:52:53,5,2639,14126,72,16837
350,2019-04-14,03:53:17,6,72,2131,250,2453
351,2019-04-14,03:53:43,13,15000,592,150,15742
352,2019-04-14,03:54:08,8,0,2428,112,2540
353,2019-04-14,03:54:33,1,36000,130,87,36217
354,2019-04-14,03:54:58,6,22622,385,1100,24107
355,2019-04-14,03:55:23,10,1872,459,16083,18414
356,2019-04-14,03:55:47,1,31490,131,122,31743
357,2019-04-14,03:56:13,8,0,130,13052,13182
358,2019-04-14,03:56:38,13,26092,90,72,26254
359,2019-04-14,03:57:03,4,277,76,50072,50425
360,2019-04-14,03:57:27,9,554,66,50072,50692
361,2019-04-14,03:57:53,10,0,71,72,143
362,2019-04-14,03:58:18,11,110,549,29923,30582
363,2019-04-14,03:58:43,3,526,82,25036,25644
364,2019-04-14,03:59:08,13,839,58,0,897
365,2019-04-14,03:59:33,10,131,120,20224,20475
366,2019-04-14,03:59:58,5,100,56,25520,25676
367,2019-04-14,04:00:23,0,0,122,25000,25122
368,2019-04-14,04:00:48,12,162,15592,0,15754
369,2019-04-14,04:01:13,2,16084,5654,82,21820
370,2019-04-14,04:01:38,7,172,10119,0,10291
371,2019-04-14,04:02:03,10,72,104,448,624
372,2019-04-14,04:02:28,2,10770,849,496,12115
373,2019-04-14,04:02:53,8,12262,310,174,12746
374,2019-04-14,04:03:18,0,1529,1031,3574,6134
375,2019-04-14,04:03:43,6,2762,1393,0,4155
376,2019-04-14,04:04:08,0,1012,328,1158,2498
377,2019-04-14,04:04:33,14,2445,11328,2924,16697
378,2019-04-14,04:04:58,12,653,14472,208,15333
379,2019-04-14,04:05:23,13,234,3720,643,4597
380,2019-04-14,04:05:48,12,547,160,102,809
381,2019-04-14,04:06:13,10,916,1328,13562,15806
382,2019-04-14,04:06:38,14,5077,1033,16168,22278
383,2019-04-14,04:07:03,0,1900,96,19960,21956
384,2019-04-14,04:07:28,2,1489,19209,10000,30698
385,2019-04-14,04:07:53,3,2366,13556,8454,24376
386,2019-04-14,04:08:18,14,5396,6076,500,11972
387,2019-04-14,04:08:43,8,7250,5374,10144,22768
388,2019-04-14,04:09:08,4,748,10263,20144,31155
389,2019-04-14,04:09:33,3,1448,5821,15300,22569
390,2019-04-14,04:09:58,7,21214,10163,10448,41825
391,2019-04-14,04:10:23,13,16301,10107,12100,38508
392,2019-04-14,04:10:50,0,10144,5712,448,16304
393,2019-04-14,04:11:13,13,15204,24485,0,39689
394,2019-04-14,04:11:38,6,59,16155,15368,31582
395,2019-04-14,04:12:03,1,1773,5852,35343,42968
396,2019-04-14,04:12:28,2,500,15548,1930,17978
397,2019-04-14,04:12:53,11,10981,5524,7864,24369
398,2019-04-14,04:13:18,14,37592,796,1230,39618
399,2019-04-14,04:13:43,12,101741,2726,1040,105507
400,2019-04-14,04:14:08,10,3489,2212,144,5845
401,2019-04-14,04:14:33,14,621,433,1050,2104
402,2019-04-14,04:14:58,8,1494,68,16746,18308
403,2019-04-14,04:15:23,11,10461,155,144,10760
404,2019-04-14,04:15:48,3,2445,736,5837,9018
405,2019-04-14,04:16:13,6,144,5239,0,5383
406,2019-04-14,04:16:38,4,1207,107,0,1314
407,2019-04-14,04:17:03,6,2120,1052,448,3620
408,2019-04-14,04:17:28,14,3932,1409,145,5486
409,2019-04-14,04:17:53,3,11144,3112,0,14256
410,2019-04-14,04:18:18,13,10244,102,35270,45616
411,2019-04-14,04:18:43,7,3392,2938,36270,42600
412,2019-04-14,04:19:08,0,5000,2137,2168,9305
413,2019-04-14,04:19:33,3,5144,6520,2000,13664
414,2019-04-14,04:19:58,12,5144,2639,36828,44611
415,2019-04-14,04:20:23,14,5000,87,194,5281
416,2019-04-14,04:20:48,10,2000,3119,1110,6229
417,2019-04-14,04:21:13,3,35760,1100,944,37804
418,2019-04-14,04:21:38,14,60,253,144,457
419,2019-04-14,04:22:03,12,1493,1057,0,2550
420,2019-04-14,04:22:28,0,900,2120,5244,8264
421,2019-04-14,04:22:53,8,43052,1886,0,44938
422,2019-04-14,04:23:18,7,15149,968,144,16261
423,2019-04-14,04:23:43,1,29221,1022,144,30387
424,2019-04-14,04:24:08,3,1144,1058,0,2202
425,2019-04-14,04:24:33,10,1179,956,28315,30450
426,2019-04-14,04:24:58,1,28266,387,444,29097
427,2019-04-14,04:25:23,14,426,163,28316,28905
428,2019-04-14,04:25:48,7,764,336,100,1200
429,2019-04-14,04:26:13,6,144,1042,1208,2394
430,2019-04-14,04:26:38,3,0,4944,1109,6053
431,2019-04-14,04:27:03,7,368,2265,2263,4896
432,2019-04-14,04:27:28,13,432,1015,2444,3891
433,2019-04-14,04:27:53,2,144,2221,2000,4365
434,2019-04-14,04:28:18,3,712,2487,2597,5796
435,2019-04-14,04:28:44,1,7262,5080,3352,15694
436,2019-04-14,04:29:08,10,2316,5933,5974,14223
437,2019-04-14,04:29:33,13,652,5627,8012,14291
438,2019-04-14,04:29:58,5,322,4025,471,4818
439,2019-04-14,04:30:23,0,758,3951,5828,10537
440,2019-04-14,04:30:48,2,149,3971,560,4680
441,2019-04-14,04:31:13,2,968,4582,1726,7276
442,2019-04-14,04:31:38,10,3800,4480,4315,12595
443,2019-04-14,04:32:03,3,3672,3365,2732,9769
444,2019-04-14,04:32:28,7,1348,2045,5639,9032
445,2019-04-14,04:32:53,14,212,3470,200,3882
446,2019-04-14,04:33:18,9,4300,3846,50,8196
447,2019-04-14,04:33:43,14,112,5107,1076,6295
448,2019-04-14,04:34:08,0,6821,5904,2050,14775
449,2019-04-14,04:34:33,3,1541,2068,2052,5661
450,2019-04-14,04:34:58,11,0,4098,1070,5168
451,2019-04-14,04:35:23,5,3200,2846,1887,7933
452,2019-04-14,04:35:48,1,5449,1201,448,7098
453,2019-04-14,04:36:13,5,0,401,1137,1538
454,2019-04-14,04:36:38,2,0,894,100,994
455,2019-04-14,04:37:03,4,689,1007,100,1796
456,2019-04-14,04:37:28,12,799,1356,2728,4883
457,2019-04-14,04:37:53,2,1834,1397,40,3271
458,2019-04-14,04:38:18,5,16800,2546,3448,22794
459,2019-04-14,04:38:43,14,0,1946,112,2058
460,2019-04-14,04:39:08,1,224,1946,6690,8860
461,2019-04-14,04:39:33,8,250,720,12345,13315
462,2019-04-14,04:39:58,0,8815,2897,4054,15766
463,2019-04-14,04:40:23,4,274,4022,831,5127
464,2019-04-14,04:40:48,7,950,4089,2000,7039
465,2019-04-14,04:41:13,11,1557,2418,2174,6149
466,2019-04-14,04:41:38,0,0,5983,6414,12397
467,2019-04-14,04:42:04,11,497,5625,8250,14372
468,2019-04-14,04:42:28,13,2044,2816,5125,9985
469,2019-04-14,04:42:53,3,1857,4853,225,6935
470,2019-04-14,04:43:18,1,324,5623,4108,10055
471,2019-04-14,04:43:44,7,0,5050,3998,9048
472,2019-04-14,04:44:08,6,189,2899,10500,13588
473,2019-04-14,04:44:33,2,1178,2638,7800,11616
474,2019-04-14,04:44:58,9,2532,1626,1000,5158
475,2019-04-14,04:45:24,8,3198,1821,5000,10019
476,2019-04-14,04:45:48,3,5433,3698,4450,13581
477,2019-04-14,04:46:13,4,224,2156,1208,3588
478,2019-04-14,04:46:38,3,0,7870,16459,24329
479,2019-04-14,04:47:03,9,3110,4874,18224,26208
480,2019-04-14,04:47:29,7,298,5013,5000,10311
481,2019-04-14,04:47:53,2,29500,9026,2000,40526
482,2019-04-14,04:48:18,11,400,8734,46320,55454
483,2019-04-14,04:48:43,3,6800,4992,4224,16016
484,2019-04-14,04:49:08,11,0,3220,6500,9720
485,2019-04-14,04:49:34,3,3509,5081,448,9038
486,2019-04-14,04:49:58,0,35150,8626,42084,85860
487,2019-04-14,04:50:23,11,0,5194,278,5472
488,2019-04-14,04:50:49,12,2364,6279,13500,22143
489,2019-04-14,04:51:13,0,2104,5626,5000,12730
490,2019-04-14,04:51:40,9,309,5736,580,6625
491,2019-04-14,04:52:03,11,981,2260,5224,8465
492,2019-04-14,04:52:29,14,12852,3303,1000,17155
493,2019-04-14,04:52:54,11,23740,2110,800,26650
494,2019-04-14,04:53:19,7,2705,3598,850,7153
495,2019-04-14,04:53:43,0,1010,3745,1960,6715
496,2019-04-14,04:54:09,13,5360,7887,87,13334
497,2019-04-14,04:54:34,2,7850,3880,3587,15317
498,2019-04-14,04:54:58,11,97,3763,1160,5020
499,2019-04-14,04:55:24,9,580,3437,305,4322
500,2019-04-14,04:55:48,6,3160,3375,210,6745
501,2019-04-14,04:56:14,6,412,13408,41780,55600
502,2019-04-14,04:56:39,0,0,1750,0,1750
503,2019-04-14,04:57:04,5,5160,3021,200,8381
504,2019-04-14,04:57:28,4,3000,2027,57592,62619
505,2019-04-14,04:57:53,2,2000,2473,3660,8133
506,2019-04-14,04:58:18,13,3000,5194,3660,11854
507,2019-04-14,04:58:44,8,448,4100,671,5219
508,2019-04-14,04:59:08,6,3150,5009,3314,11473
509,2019-04-14,04:59:34,0,4443,5046,7376,16865
510,2019-04-14,04:59:58,12,1080,4037,416,5533
511,2019-04-14,05:00:24,10,997,3369,2593,6959
512,2019-04-14,05:00:49,1,2230,6438,800,9468
513,2019-04-14,05:01:14,4,775,2345,1660,4780
514,2019-04-14,05:01:39,2,2087,2034,224,4345
515,2019-04-14,05:02:04,10,5720,4082,425,10227
516,2019-04-14,05:02:28,2,300,1352,7621,9273
517,2019-04-14,05:02:54,6,3100,3955,19224,26279
518,2019-04-14,05:03:19,4,1328,1500,23003,25831
519,2019-04-14,05:03:44,3,4875,2500,18224,25599
520,2019-04-14,05:04:09,14,9469,4632,4744,18845
521,2019-04-14,05:04:33,8,314,3567,500,4381
522,2019-04-14,05:04:59,10,0,4013,6167,10180
523,2019-04-14,05:05:23,10,2020,1621,100,3741
524,2019-04-14,05:05:48,0,5529,2877,100,8506
525,2019-04-14,05:06:14,10,5084,3767,0,8851
526,2019-04-14,05:06:39,5,6172,1512,0,7684
527,2019-04-14,05:07:04,11,1491,2961,5000,9452
528,2019-04-14,05:07:29,6,4010,6297,0,10307
529,2019-04-14,05:07:54,12,2000,1070,0,3070
530,2019-04-14,05:08:19,12,1262,2071,1000,4333
531,2019-04-14,05:08:44,13,1161,72,0,1233
532,2019-04-14,05:09:08,2,50,11094,28,11172
533,2019-04-14,05:09:34,12,4028,75,0,4103
534,2019-04-14,05:09:59,12,760,17944,0,18704
535,2019-04-14,05:10:24,6,8283,3119,903,12305
536,2019-04-14,05:10:49,8,11500,670,1927,14097
537,2019-04-14,05:11:14,0,14030,2641,2060,18731
538,2019-04-14,05:11:39,3,837,2873,0,3710
539,2019-04-14,05:12:04,3,1122,2675,0,3797
540,2019-04-14,05:12:32,13,12106,3175,864,16145
541,2019-04-14,05:13:19,6,1223,845,1875,3943
542,2019-04-14,05:13:44,14,3248,1576,7105,11929
543,2019-04-14,05:14:09,14,1812,4529,0,6341
544,2019-04-14,05:14:34,14,8714,3521,2910,15145
545,2019-04-14,05:14:59,6,3274,3094,8,6376
546,2019-04-14,05:15:24,8,1508,1090,1500,4098
547,2019-04-14,05:15:49,10,1010,4867,3103,8980
548,2019-04-14,05:16:13,6,12270,4348,6300,22918
549,2019-04-14,05:16:39,2,1500,3665,456,5621
550,2019-04-14,05:17:04,9,7150,3442,293,10885
551,2019-04-14,05:17:29,6,2510,3366,800,6676
552,2019-04-14,05:17:54,6,2626,3690,4500,10816
553,2019-04-14,05:18:19,13,2000,9515,3185,14700
554,2019-04-14,05:18:44,4,2968,13561,0,16529
555,2019-04-14,05:19:09,14,4400,6310,3250,13960
556,2019-04-14,05:19:34,6,8310,5641,2500,16451
557,2019-04-14,05:19:59,5,10325,2974,600,13899
558,2019-04-14,05:20:24,5,6828,4678,892,12398
559,2019-04-14,05:20:49,1,9750,15756,437,25943
560,2019-04-14,05:21:15,6,900,3626,354,4880
561,2019-04-14,05:21:40,11,3156,4274,2156,9586
562,2019-04-14,05:22:05,10,1305,4018,380,5703
563,2019-04-14,05:22:30,0,3425,5579,2646,11650
564,2019-04-14,05:22:56,0,1204,13349,8250,22803
565,2019-04-14,05:23:20,13,3655,18739,5100,27494
566,2019-04-14,05:23:45,8,15004,2672,1308,18984
567,2019-04-14,05:24:10,8,6112,4603,2926,13641
568,2019-04-14,05:24:35,6,24151,4044,938,29133
569,2019-04-14,05:25:00,4,4719,3926,5500,14145
570,2019-04-14,05:25:25,13,3967,4104,1493,9564
571,2019-04-14,05:25:50,2,4018,3186,1211,8415
572,2019-04-14,05:26:15,13,3550,2900,7760,14210
573,2019-04-14,05:26:40,14,7957,6018,0,13975
574,2019-04-14,05:27:05,8,8270,8971,4360,21601
575,2019-04-14,05:27:30,8,8636,8338,1062,18036
576,2019-04-14,05:27:55,5,7601,3383,1310,12294
577,2019-04-14,05:28:20,14,6276,4214,1000,11490
578,2019-04-14,05:28:45,6,5010,3866,1100,9976
579,2019-04-14,05:29:10,3,4510,3359,5087,12956
580,2019-04-14,05:29:35,5,6000,3416,540,9956
581,2019-04-14,05:30:00,2,13506,3440,765,17711
582,2019-04-14,05:30:25,3,5896,3965,2000,11861
583,2019-04-14,05:30:50,14,7000,4440,396,11836
584,2019-04-14,05:31:15,4,7596,4791,396,12783
585,2019-04-14,05:31:40,0,0,12169,7700,19869
586,2019-04-14,05:32:05,12,5458,5659,0,11117
587,2019-04-14,05:32:30,10,7227,5261,0,12488
588,2019-04-14,05:32:55,2,596,4594,450,5640
589,2019-04-14,05:33:20,9,819,5194,0,6013
590,2019-04-14,05:33:45,12,4115,4418,0,8533
591,2019-04-14,05:34:10,3,20,5301,6000,11321
592,2019-04-14,05:34:36,10,41100,7564,4500,53164
593,2019-04-14,05:35:00,0,20296,5752,408,26456
594,2019-04-14,05:35:25,13,60020,8232,5000,73252
595,2019-04-14,05:35:50,8,13758,5960,9892,29610
596,2019-04-14,05:36:15,3,101,6342,3460,9903
597,2019-04-14,05:36:40,6,63738,10244,650,74632
598,2019-04-14,05:37:05,9,2004,4399,6000,12403
599,2019-04-14,05:37:30,10,1020,4300,6500,11820
600,2019-04-14,05:37:55,2,40,3982,10600,14622
601,2019-04-14,05:38:20,5,3822,1713,5000,10535
602,2019-04-14,05:38:45,4,6644,1549,0,8193
603,2019-04-14,05:39:10,12,396,2125,1344,3865
604,2019-04-14,05:39:35,4,3906,4376,0,8282
605,2019-04-14,05:40:00,14,1086,5895,3000,9981
606,2019-04-14,05:40:25,0,2510,156295,0,158805
607,2019-04-14,05:40:50,4,320,154476,0,154796
608,2019-04-14,05:41:15,7,400,152429,2050,154879
609,2019-04-14,05:41:40,2,5980,1568,841,8389
610,2019-04-14,05:42:05,2,6906,202226,500363,709495
611,2019-04-14,05:42:30,11,5586,6592,1505107,1517285
612,2019-04-14,05:42:55,5,4462,154441,10715,169618
613,2019-04-14,05:43:20,3,10498,4608,8968,24074
614,2019-04-14,05:43:45,12,3473,8997,11190,23660
615,2019-04-14,05:44:10,6,4719,3039,1464,9222
616,2019-04-14,05:44:35,1,300,3268,3390,6958
617,2019-04-14,05:45:00,2,4165,3012,1395,8572
618,2019-04-14,05:45:25,14,9225,6635,275,16135
619,2019-04-14,05:45:50,11,4409,7508,6735,18652
620,2019-04-14,05:46:15,10,220,3700,4316,8236
621,2019-04-14,05:46:40,13,2077,5692,10000,17769
622,2019-04-14,05:47:05,8,402,5616,6000,12018
623,2019-04-14,05:47:30,8,5706,3882,2335,11923
624,2019-04-14,05:47:55,10,13818,4319,2534,20671
625,2019-04-14,05:48:20,9,11356,5533,9518,26407
626,2019-04-14,05:48:45,11,26511,6367,3190,36068
627,2019-04-14,05:49:10,7,29307,7252,2993,39552
628,2019-04-14,05:49:35,14,27650,5586,0,33236
629,2019-04-14,05:50:00,0,43862,8389,18,52269
630,2019-04-14,05:50:26,1,2970,9692,3076,15738
631,2019-04-14,05:50:50,9,1253,51944,3250,56447
632,2019-04-14,05:51:15,9,8560,3143,165,11868
633,2019-04-14,05:51:40,9,3836,2609,4507,10952
634,2019-04-14,05:52:05,6,6177,3659,3474,13310
635,2019-04-14,05:52:30,6,3090,4519,0,7609
636,2019-04-14,05:52:55,7,4900,4783,750,10433
637,2019-04-14,05:53:20,0,4929,6648,2251,13828
638,2019-04-14,05:53:45,1,2540,9982,3151,15673
639,2019-04-14,05:54:10,9,1081,6044,4062,11187
640,2019-04-14,05:54:35,6,4491,9150,9377,23018
641,2019-04-14,05:55:00,11,2345,6717,8395,17457
642,2019-04-14,05:55:26,10,3052,7241,2250,12543
643,2019-04-14,05:55:50,10,2581,10337,8750,21668
644,2019-04-14,05:56:15,13,5630,4981,4654,15265
645,2019-04-14,05:56:40,9,4362,6432,3100,13894
646,2019-04-14,05:57:05,11,3206,5118,3160,11484
647,2019-04-14,05:57:30,2,5420,5353,5346,16119
648,2019-04-14,05:57:56,7,2006,5164,2500,9670
649,2019-04-14,05:58:20,10,948,6288,1650,8886
650,2019-04-14,05:58:45,1,7946,4715,360,13021
651,2019-04-14,05:59:10,5,1384,5310,2419,9113
652,2019-04-14,05:59:35,1,4302,5386,2608,12296
653,2019-04-14,06:00:00,8,4610,5900,1,10511
654,2019-04-14,06:00:25,13,3112,6386,187,9685
655,2019-04-14,06:00:50,2,2020,6004,187,8211
656,2019-04-14,06:01:16,13,55,5532,1894,7481
657,2019-04-14,06:01:40,11,8036,3857,420,12313
658,2019-04-14,06:02:06,4,12020,3904,2056,17980
659,2019-04-14,06:02:30,0,15000,3524,2551,21075
660,2019-04-14,06:02:55,9,7956,8233,3000,19189
661,2019-04-14,06:03:20,10,1520,6064,104,7688
662,2019-04-14,06:03:46,13,526,3504,2500,6530
663,2019-04-14,06:04:10,4,205,1010,2352,3567
664,2019-04-14,06:04:36,3,629,4502,3428,8559
665,2019-04-14,06:05:01,12,204,1856,8645,10705
666,2019-04-14,06:05:25,11,3155,6075,5194,14424
667,2019-04-14,06:05:50,14,4020,3152,0,7172
668,2019-04-14,06:06:16,10,51,2131,2500,4682
669,2019-04-14,06:06:40,6,102,2285,250,2637
670,2019-04-14,06:07:05,9,0,2089,5000,7089
671,2019-04-14,06:07:31,9,7880,1590,498,9968
672,2019-04-14,06:07:55,5,3914,1180,104,5198
673,2019-04-14,06:08:20,14,4000,2589,2500,9089
674,2019-04-14,06:08:45,5,1510,1088,105,2703
675,2019-04-14,06:09:10,7,3,1521,2500,4024
676,2019-04-14,06:09:36,5,1,1930,0,1931
677,2019-04-14,06:10:01,9,3390,3175,2,6567
678,2019-04-14,06:10:26,3,1710,3847,2325,7882
679,2019-04-14,06:10:50,10,3271,6859,4202,14332
680,2019-04-14,06:11:15,9,4066,5319,7320,16705
681,2019-04-14,06:11:40,6,6484,5515,6519,18518
682,2019-04-14,06:12:06,12,3772,3955,6270,13997
683,2019-04-14,06:12:30,10,3032,3941,4004,10977
684,2019-04-14,06:12:55,14,3020,3622,1,6643
685,2019-04-14,06:13:21,10,555,4936,6789,12280
686,2019-04-14,06:13:45,3,6102,2990,1,9093
687,2019-04-14,06:14:10,3,3202,3235,103,6540
688,2019-04-14,06:14:35,14,7701,4415,894,13010
689,2019-04-14,06:15:00,10,5361,5176,1502,12039
690,2019-04-14,06:15:26,6,4520,6389,5604,16513
691,2019-04-14,06:15:50,13,10877,1225,2500,14602
692,2019-04-14,06:16:16,9,20746,5276,4,26026
693,2019-04-14,06:16:41,8,20,2266,1,2287
694,2019-04-14,06:17:06,14,52,4044,10001,14097
695,2019-04-14,06:17:31,7,4783,3842,1,8626
696,2019-04-14,06:17:55,0,39004,7418,445,46867
697,2019-04-14,06:18:21,2,39634,15259,200,55093
698,2019-04-14,06:18:46,0,2860,4325,0,7185
699,2019-04-14,06:19:11,3,4714,10988,751,16453
700,2019-04-14,06:19:35,1,6038,5311,492,11841
701,2019-04-14,06:20:00,14,5253,5920,2504,13677
702,2019-04-14,06:20:27,8,10264,3091,3502,16857
703,2019-04-14,06:20:51,2,2896,3969,2201,9066
704,2019-04-14,06:21:16,7,3936,5620,9129,18685
705,2019-04-14,06:21:40,3,1067,5405,0,6472
706,2019-04-14,06:22:06,7,5078,4876,346,10300
707,2019-04-14,06:22:31,2,12737,5325,2001,20063
708,2019-04-14,06:22:56,5,10003,4740,401,15144
709,2019-04-14,06:23:21,5,9424,6262,436,16122
710,2019-04-14,06:23:46,12,3328,5384,2709,11421
711,2019-04-14,06:24:11,2,134,4235,46457,50826
712,2019-04-14,06:24:36,7,2736,2895,2224,7855
713,2019-04-14,06:25:01,0,7143,4332,3550,15025
714,2019-04-14,06:25:26,7,379,7072,12360,19811
715,2019-04-14,06:25:51,2,1671,5966,94,7731
716,2019-04-14,06:26:16,10,1051,5107,5344,11502
717,2019-04-14,06:26:41,5,7062,4992,3502,15556
718,2019-04-14,06:27:06,1,1348,3556,4000,8904
719,2019-04-14,06:27:31,12,6003,3009,386,9398
720,2019-04-14,06:27:56,2,14,2721,4838,7573
721,2019-04-14,06:28:21,8,342,2220,3000,5562
722,2019-04-14,06:28:46,4,1034,3691,4008,8733
723,2019-04-14,06:29:11,3,19,3526,0,3545
724,2019-04-14,06:29:36,9,3,3190,0,3193
725,2019-04-14,06:30:01,5,14,3191,2,3207
726,2019-04-14,06:30:26,14,18004,3318,5872,27194
727,2019-04-14,06:30:51,0,346,4414,8,4768
728,2019-04-14,06:31:16,4,20,4793,0,4813
729,2019-04-14,06:31:41,6,36,3561,0,3597
730,2019-04-14,06:32:06,3,3023,5827,1515,10365
731,2019-04-14,06:32:31,1,829,5183,756,6768
732,2019-04-14,06:32:56,0,1778,5109,3292,10179
733,2019-04-14,06:33:21,0,794,6600,654,8048
734,2019-04-14,06:33:46,9,756,9091,98,9945
735,2019-04-14,06:34:11,12,216,6666,752,7634
736,2019-04-14,06:34:36,1,224,2516,691,3431
737,2019-04-14,06:35:01,7,4,3446,2160,5610
738,2019-04-14,06:35:26,10,1623,3628,406,5657
739,2019-04-14,06:35:51,9,1466,4359,2,5827
740,2019-04-14,06:36:16,8,575,4253,5262,10090
741,2019-04-14,06:36:41,11,3669,4642,4001,12312
742,2019-04-14,06:37:06,5,1884,5693,8467,16044
743,2019-04-14,06:37:31,11,4,4203,8120,12327
744,2019-04-14,06:37:56,12,400,4825,404,5629
745,2019-04-14,06:38:21,1,9611,6664,1,16276
746,2019-04-14,06:38:46,10,4604,4808,2200,11612
747,2019-04-14,06:39:11,13,1174,6153,254,7581
748,2019-04-14,06:39:36,8,6828,5133,256,12217
749,2019-04-14,06:40:01,0,1566,5432,26,7024
750,2019-04-14,06:40:26,5,2438,3707,0,6145
751,2019-04-14,06:40:51,14,1956,2382,0,4338
752,2019-04-14,06:41:16,11,2674,3107,308,6089
753,2019-04-14,06:41:41,3,1688,3162,1,4851
754,2019-04-14,06:42:06,11,304,3351,800,4455
755,2019-04-14,06:42:31,0,2348,3749,304,6401
756,2019-04-14,06:42:56,11,1928,4912,0,6840
757,2019-04-14,06:43:21,1,3980,7155,2469,13604
758,2019-04-14,06:43:48,8,4696,4583,1161,10440
759,2019-04-14,06:44:11,11,5788,8106,8513,22407
760,2019-04-14,06:44:36,12,4858,8785,15929,29572
761,2019-04-14,06:45:01,7,4106,6751,7401,18258
762,2019-04-14,06:45:26,9,4,4669,4580,9253
763,2019-04-14,06:45:52,0,17014,6198,1596,24808
764,2019-04-14,06:46:16,10,22328,10617,8,32953
765,2019-04-14,06:46:41,3,16696,5661,25,22382
766,2019-04-14,06:47:06,5,853,8377,11184,20414
767,2019-04-14,06:47:31,7,3964,6812,10073,20849
768,2019-04-14,06:47:56,10,85731,3870,538,90139
769,2019-04-14,06:48:21,13,505,7083,14107,21695
770,2019-04-14,06:48:46,7,2028,4714,5025,11767
771,2019-04-14,06:49:11,10,243,2393,3150,5786
772,2019-04-14,06:49:36,2,11288,8461,5688,25437
773,2019-04-14,06:50:01,3,7072,8223,6050,21345
774,2019-04-14,06:50:26,13,8925,9278,6842,25045
775,2019-04-14,06:50:51,10,298,6888,11127,18313
776,2019-04-14,06:51:16,0,10878,7313,196,18387
777,2019-04-14,06:51:41,4,9666,7199,75,16940
778,2019-04-14,06:52:06,1,9611,10477,10250,30338
779,2019-04-14,06:52:31,3,5826,6360,10550,22736
780,2019-04-14,06:52:56,9,5370,8631,11101,25102
781,2019-04-14,06:53:21,11,27976,11271,10132,49379
782,2019-04-14,06:53:47,6,3529,7422,10121,21072
783,2019-04-14,06:54:11,1,24,12650,14900,27574
784,2019-04-14,06:54:36,12,1903,5866,9725,17494
785,2019-04-14,06:55:02,6,150,5999,9867,16016
786,2019-04-14,06:55:26,14,10298,5902,450,16650
787,2019-04-14,06:55:51,2,10169,5726,223,16118
788,2019-04-14,06:56:16,13,12719,7481,250,20450
789,2019-04-14,06:56:41,12,7699,7971,9851,25521
790,2019-04-14,06:57:06,5,10968,11327,1,22296
791,2019-04-14,06:57:31,1,10104,7513,3600,21217
792,2019-04-14,06:57:56,11,2013,9238,10152,21403
793,2019-04-14,06:58:22,4,6066,12108,11752,29926
794,2019-04-14,06:58:46,3,10616,8792,2000,21408
795,2019-04-14,06:59:11,1,10613,6064,2200,18877
796,2019-04-14,06:59:36,11,1263,7911,13029,22203
797,2019-04-14,07:00:01,10,39,9333,10502,19874
798,2019-04-14,07:00:26,3,591,6258,10601,17450
799,2019-04-14,07:00:51,3,10314,7090,0,17404
800,2019-04-14,07:01:16,4,10057,7812,1100,18969
801,2019-04-14,07:01:41,13,615,7123,11092,18830
802,2019-04-14,07:02:07,11,4392,7429,12455,24276
803,2019-04-14,07:02:31,12,1989,6630,9951,18570
804,2019-04-14,07:02:57,1,10599,6757,391,17747
805,2019-04-14,07:03:21,2,15814,7369,1132,24315
806,2019-04-14,07:03:46,10,10667,7753,100,18520
807,2019-04-14,07:04:12,3,1993,7424,9712,19129
808,2019-04-14,07:04:36,5,10246,9171,3117,22534
809,2019-04-14,07:05:02,4,23,13583,11700,25306
810,2019-04-14,07:05:28,3,903,10333,17122,28358
811,2019-04-14,07:05:51,9,264,8545,11047,19856
812,2019-04-14,07:06:17,4,2029,9940,11618,23587
813,2019-04-14,07:06:41,7,1547,10932,12936,25415
814,2019-04-14,07:07:06,5,539,7950,11540,20029
815,2019-04-14,07:07:32,13,1194,7770,10400,19364
816,2019-04-14,07:07:56,1,316,5401,122,5839
817,2019-04-14,07:08:25,9,9747,5325,200,15272
818,2019-04-14,07:08:46,2,9912,6376,128,16416
819,2019-04-14,07:09:11,1,118,6375,9850,16343
820,2019-04-14,07:09:36,10,206,5875,9600,15681
821,2019-04-14,07:10:01,1,520,6081,9776,16377
822,2019-04-14,07:10:26,11,9707,6892,100,16699
823,2019-04-14,07:10:51,4,9916,11522,408,21846
824,2019-04-14,07:11:16,14,120,7025,9800,16945
825,2019-04-14,07:11:42,4,10166,6976,36,17178
826,2019-04-14,07:12:06,12,329,7600,10059,17988
827,2019-04-14,07:12:32,14,416,4393,1660,6469
828,2019-04-14,07:12:57,7,10532,6602,1201,18335
829,2019-04-14,07:13:21,14,3206,8054,10200,21460
830,2019-04-14,07:13:46,5,1068,3895,2604,7567
831,2019-04-14,07:14:11,0,459,8069,10808,19336
832,2019-04-14,07:14:36,13,2312,8486,10500,21298
833,2019-04-14,07:15:01,9,4021,7035,9736,20792
834,2019-04-14,07:15:26,14,13832,6632,1501,21965
835,2019-04-14,07:15:51,9,11704,2846,2950,17500
836,2019-04-14,07:16:19,6,12250,6820,3137,22207
837,2019-04-14,07:16:44,4,11178,5735,8221,25134
838,2019-04-14,07:17:09,1,9825,6353,633,16811
839,2019-04-14,07:17:34,7,10349,6675,2385,19409
840,2019-04-14,07:17:59,3,1544,8280,11601,21425
841,2019-04-14,07:18:24,13,2675,7571,10432,20678
842,2019-04-14,07:18:49,7,20,7043,10357,17420
843,2019-04-14,07:19:15,13,5226,5487,0,10713
844,2019-04-14,07:19:39,6,11231,7355,695,19281
845,2019-04-14,07:20:04,9,933,5996,10800,17729
846,2019-04-14,07:20:29,0,11031,6081,1666,18778
847,2019-04-14,07:20:54,11,9624,15386,4552,29562
848,2019-04-14,07:21:19,0,10408,8928,6812,26148
849,2019-04-14,07:21:44,9,11218,12571,200,23989
850,2019-04-14,07:22:09,7,11418,10694,906,23018
851,2019-04-14,07:22:35,7,12984,8311,243,21538
852,2019-04-14,07:23:00,10,1802,8619,9600,20021
853,2019-04-14,07:23:24,9,2262,8680,9752,20694
854,2019-04-14,07:23:49,6,12624,11600,285,24509
855,2019-04-14,07:24:14,14,13205,9716,50,22971
856,2019-04-14,07:24:39,5,11954,10173,204,22331
857,2019-04-14,07:25:04,8,4409,8759,10120,23288
858,2019-04-14,07:25:29,0,9612,8900,10967,29479
859,2019-04-14,07:25:54,8,13024,37199,250,50473
860,2019-04-14,07:26:20,7,9658,14629,4476,28763
861,2019-04-14,07:26:44,12,9761,9745,10070,29576
862,2019-04-14,07:27:10,5,12165,10587,6004,28756
863,2019-04-14,07:27:34,5,5484,6787,9900,22171
864,2019-04-14,07:28:00,10,11022,8643,16525,36190
865,2019-04-14,07:28:24,11,19257,6758,2405,28420
866,2019-04-14,07:28:49,3,15624,7528,4223,27375
867,2019-04-14,07:29:15,1,11203,11065,220,22488
868,2019-04-14,07:29:39,1,4552,6590,19010,30152
869,2019-04-14,07:30:04,1,52,7790,11100,18942
870,2019-04-14,07:30:29,7,3002,8379,12951,24332
871,2019-04-14,07:30:54,10,3025,7060,16602,26687
872,2019-04-14,07:31:19,1,3817,8340,15940,28097
873,2019-04-14,07:31:44,6,2105,10943,11850,24898
874,2019-04-14,07:32:10,10,502,26870,10600,37972
875,2019-04-14,07:32:34,14,262,15861,12980,29103
876,2019-04-14,07:32:59,1,11165,5887,581,17633
